##############################
#************#***************#
#************#***************#
#************#***************#
#************#***************#
#************#***************#
#************#***************#
#************#***************#
#****************************#
#****************************#
#************#***************#
#************#***************#
#************#***************#
#************#***************#
##############################